article	самодостаточный, полный блок текста

aside	блок текста, косвенно связанный с темой страницы

figure, img, figcaption	figure - блочный элемент из картинки(img) и его описания( figcaption)

header, footer	колонтитулы; содержат +/- статичную информацию

hgroup	бета-версия! изолятор разделов, так внутри разных <hgroup></hgroup> хранятся разные иерархии заголовков(h1-h6)

nav	блок навигации; может содержать якоря или меню сайта

section	композиционный элемент статьи, имеющий собственный смысл, в рамках основной темы.

section, article	Если контент, будучи отделённым, продолжает быть смысловой еденицей, то лучше использовать article

details, summary	теги спойлера; самари - заголовок; то что кроме - содержимое


синтаксис details 	<details>  <summary>clickbait</summary>  nothing major </details>

main	главный смысловой(article?) блок страницы

mark	тег семантического выделения, определяет тезисы приложений подтвеждающие генеральную линию

time	парный тег, в содержимом своём содержит описание времени для юзеров, в аттрибуте datetime - оцифровываемое по стандарту

wbr	WordBReak, одинарный, разрешение для переноса разрывом слова, внутри тега

запись wbr 	<wbr />


[2]

input	тег ввода данных, заслуживает отдельного курса gb

datalist, option	парный тег, содержит коллекцию парных тегов option. Содержимое тегов option - варианты выбора...

где отражены options из datalist	<input list="datalist_id">

аттрибут имени <input list>	<input name="my_list_name" list="datalist_id">

синтаксис заголовка <input list="#">	<label for="my_list_name"> visible name!</label>

обязательный, связующий аттрибут datalist	 id; <datalist id="datalist_id">

синтаксис option	<option value="element_key">Element promotion</option>

keygen	формирует двусоставный ключ; публичная часть уходит на сервер, приватная остаётся у пользователя

meter, progress	теги-шкалы; meter - визуальное отображение доли(%, fr); progress - шкала выполнения процесса

menu, что там лежит	альтернатива ul; применяется для хранения интерактивных элементов

output	тег для вывода вычислений

audio, video	теги медиа-контента

source	тег ветвления источника для медиа-тегов, по предусловиям

track	дочерний тег медиа-тегов, субтитры

embed	(англ. вставлять), тег вложенных медиа 

[3]

canvas	холст для отрисовки js-скриптов

address	семантический тег, адрес для связующий

blockquote	семантитеческий тег цитаты

blockquote > footer футер внутри блокквота - указывает на автора цитаты

обобщение по семантике	div - базовый блок страницы, seo не может на глазок определить что это. Семантические теги - дивы, с комментарием понятным как разработчику, так и роботу.

form	тег, объединяющий элементы управления страницей и отправляющий вывод на сервер

аттрибут form для отправки элемента на сервер	action

называем как-то поле input	<label for="input_id">input_name</label>

инпут- выпадающий список	<select id="input_id">
<option value="a">a!</option>
</select>

инпут больших записей	textarea, парный

инпут-галочка да-нет	<label for="input_id"><input type="checkbox">Note_on_input</label>

инпут-пароль	<input type="password">

инпут-исключающее или	<input type="radio">

вводы "отправить"(2), и их различия	type="submit", "image"; функции одинаковые ; image заточена под внешний вид элемента



[4]

кнопка с кастомным js функционалом	<input type="button">

аттрибут input-подсказка ввода	placeholder="input example"

аттрибут input- фокусировка на элементе	autofocus, <input placeholder="start here" autofocus>

аттрибут input - запрет пустого ввода	required, <input required>

отключение проверки	<form novalidate>

ожидаемый тип ввода, почта, сайт,число 	<input type="email | URL | number ">

несколько header  в рамках страницы	можно, это шапка так же и разделов

подсказка по вводу обязательного поля 	<input required title="hint">

регулярные выражения: цифры, не-цифры	\d [0-9] \D[^0-9]

(рег.выр.)любая буква кириллицы-латинницы	[a-zA-Zа-яА-ЯёЁ]{1,}

(рег.выр.)три цифры	[0-9]{3}

(рег.выр.)не более трёх букв, не менее трёх букв	[a-z]{,3} [a-Z]{3,}

(рег.выр.)маска цифры, маска буквы \d 123 \D asd

(рег.выр.) декорирующий символ	\

задаём пределы на  ввод числа	<input type="number" min="0" max="1">

задаём значение ввода по умолчанию <input type = "text"  value="sample" >

